Level 2
##################
# P              #
#                #
#           D    #
#                #
#                #
#           K    #
##################