Level 4
#####################
#P#   # #     #   # #
# # # # # # ### ### #
# # #   #K#         #
# # ####### #########
#   #   #         # #
### # # ### ### ### #
#     #       #   # #
# ### ### # ### # # #
# #   #   # #   #   #
###################D#
