Level 2
#############
#P       #  #
# ### # # ###
#   # #     #
# ####### # #
#  K#     # #
###########D# 
