Level 6
#############################
#P# #   #   #       #       #
# # # # # ### ##### # ### # #
# #   #   # #K#         # # #
# ### ### # ##### # # # ### #
#   # #   #   #   # # # # # #
### ### ### ######### ### # #
#   # # #     # # # #     # #
# ### # ### ### # # ####### #
#         #   #     #       #
# ### ### # ### # ### # #####
#   # # #       # # # #     #
### # # ### # ##### # # ### #
#   # #     #         # #   #
###########################D# 