Level 5
#########################
#P     #     # #K   # # #
##### ##### # # ### # # #
#   #         #       # #
### # ########### ### # #
#   #       # #     # # #
# ### ### ### # # #######
#   #   # #     # #     #
# ### ####### ### # # # #
#   #   # # # #     # # #
# ### ### # # ### # ### #
#             #   # #   #
#######################D# 