Level 3
#################
#P  #   # #K  # #
### # # # ### # #
#     # # # # # #
### ##### # # # #
#     # #       #
### # # # # #####
#   #     #     #
###############D# 
