##################
#P #             #
#                #
#                #
#                #
#                #
#                #
##################