Level 1
#########
#P  #K  #
# # ### #
# #     #
#######D#