Level 1
##################
# P#             #
#  # #####       #
#  # #   #  D    #
#  #   # #       #
#  ## ## ####    #
#     #    K#    #
##################